salvadoran	nw
italian	w
jamaican	nw
thai	nw
german	w
persian	nw
belgian	w
japanese	nw
russian	w
mexican	nw
moroccan	nw
indian	nw
american	w
cuban	nw
roman	w
malaysian	nw
colombian	nw
peruvian	nw
sicilian	w
breton	w
tunisian	nw
hungarian	w
javanese	nw
brazilian	nw
malagasy	nw
hamburger	-1
libyan	nw
syrian	nw
singaporean	nw
haitian	nw
indonesian	nw
america	w
bangladeshi	nw
ghanaian	nw
genovese	w
armenian	nw
chilean	nw
alaskan	w
andalusian	w
egyptian	nw
iranian	nw
baja	nw
victorian	w
valencian	w
algerian	nw
bosnian	w
majorcan	w
macedonian	w
bohemian	w
ukrainian	w
bulgarian	w
liberian	nw
georgian	w
ligurian	w
galician	w
